election	elections	
hidden	missing	dead	
destroyed	fed	damaged	burned	killed	
future	good	real	
safe	dangerous	
environment	presence	
payable	dividend	discount	
treating	starter	
becoming	being	
self-rule	sovereignty	hinterland	independence	
deputy	prime	chief	
role	relationship	
policeman	soldier	
sound	light	material	
drivers	cars	riders	vehicles	
explain	investigate	discuss	understand	
store	plant	
entry	priority	
sexually	beef	
ride	stop	train	
occupation	militia	
smuggling	sic	
establish	strengthen	restore	
information	data	
net	rating	
look	feel	stand	
statement	proposal	
continuous	partial	rapid	
crucial	decisive	
wrote	notes	spoke	
balls	holes	
missing	hidden	dead	
film	video	
lagging	progressing	
hampered	speculation	
even	yet	possibly	
fell	drove	broke	
generally	often	traditionally	normally	sometimes	
preparing	putting	saving	keeping	
struggle	fight	defeat	
new	traditional	
composer	critic	
longer	otherwise	
electronic	digital	computer	
reporting	monitoring	planning	testing	
towns	cities	settlements	
citizen	servant	
refusing	fatal	
underlying	precise	exact	
global	corporate	strategic	collective	
credit	revenue	sales	
pumps	batches	
offer	share	shares	
weapons	propaganda	intelligence	
potential	mutual	
revolt	yields	
decided	hoped	
rounds	pairs	shots	
ceremony	festival	calendar	celebration	
black	white	dark	red	
signal	transmission	noise	
spokesman	midfielder	striker	defender	
light	sound	
study	report	survey	
chances	nowhere	
businessman	lawyer	
end	start	
tie	roll	
concert	tour	
winners	champions	winner	
via	beyond	through	
tunnel	passage	route	trail	
dogs	bones	clothes	
hundreds	millions	thousands	
briefly	repeatedly	
constitution	legislature	
powerful	strong	dominant	
benefit	risk	
highest	largest	same	
rainfall	week-long	
spite	fate	truth	
rising	breaking	falling	
illegal	criminal	secret	
nearly	virtually	roughly	
owner	owners	workers	
candidate	leader	
weekly	monthly	daily	
suspension	speech	motion	
good	future	bad	real	
hide	reveal	refuse	
selling	paying	spending	
her	his	
neighbouring	mainland	
coconut	year-end	
flow	flows	
wave	surge	
provinces	districts	states	
servants	pursuing	
seeds	ones	
have	had	has	
sovereignty	self-rule	hinterland	independence	
solitary	sporadic	unspecified	
jobs	customers	
indeed	perhaps	certainly	
perfectly	balloting	
badly	severely	seriously	
skin	hair	eye	
into	through	onto	
four	five	seven	nine	three	eight	six	two	
once	just	
compound	den	der	
midfielder	spokesman	
responsibility	permission	duties	guidance	
cars	drivers	bars	vehicles	
copper	grain	lumber	
meal	prayer	birthday	
rocks	holes	waters	
isolated	remote	
worsened	scoreline	
vehicle	motor	
infringement	reject	
holds	offers	carries	serves	provides	
patients	doctors	
lose	bring	save	keep	
voters	votes	candidates	
submitted	issued	
medallist	reliever	
warnings	wounds	
blast	preference	
palace	tomb	
they	she	
unsure	pneumonia	
history	tradition	culture	
budget	loan	debt	
seconds	hours	weeks	minutes	
picture	copy	table	
very	relatively	extremely	fairly	highly	
executive	representative	
numbers	scores	statistics	
institutions	groups	
soon	eventually	further	
lands	borders	
string	row	pattern	
decisions	goals	
scale	range	
conservative	radical	liberal	democratic	
contribution	commitment	
permanent	joint	temporary	
postponed	delayed	
liquor	beer	
club	stadium	player	team	
differences	values	
interviews	videos	magazines	
sexual	sex	
southwest	northeast	southeast	northwest	
maintenance	building	construction	
operations	operation	supplies	
negotiate	recover	seize	settle	withdraw	
deny	exclude	
infrastructure	economy	
holding	calling	carrying	
person	thing	man	
protest	debate	controversy	criticism	
group	star	band	
defensive	wing	
later	earlier	
ends	turns	moves	
strong	powerful	dominant	
yet	even	
shared	maintained	supported	
sport	racing	football	sports	
holes	balls	rocks	
planned	proposed	
options	requirements	standards	
nuclear	naval	civilian	
body	head	
forms	elements	
emotional	mental	spiritual	romantic	
committee	commission	
respectively	plus	
eat	find	kill	
which	that	
blood	pain	
putting	preparing	bringing	saving	keeping	
before	until	
retail	commercial	consumer	
racing	sport	sports	
divorce	marriage	
idea	possibility	
knowledge	nature	importance	
become	remain	
farms	homes	farmers	markets	
considering	suggesting	indicating	
health	education	medical	drug	
stay	leave	
costly	secure	effective	
custody	jail	prison	
showing	finding	representing	
departure	toll	
release	lead	
ever	previously	
race	competition	
daughter	father	wife	husband	brother	mother	son	
haul	sweep	halt	
convention	conference	
discovered	found	recovered	
roads	boats	streets	
turns	ends	moves	
debate	protest	controversy	criticism	
report	study	survey	
want	know	think	
travelling	walking	
gained	earned	faced	
penalties	denote	packed	
della	mixed	
successful	unsuccessful	
easier	suitable	
gloom	pellets	blown	
recommendations	blocked	
investigation	inquiry	investigations	
nearby	near	
services	service	training	offices	
quickly	effectively	rapidly	instantly	slowly	
laws	judges	rules	policies	
season	year	
weight	speed	
soldier	policeman	boy	
semifinalist	veteran	
opened	operated	served	
country	community	
move	push	pull	
companies	firms	
host	pilot	
virtually	nearly	roughly	
surgeon	doctor	nurse	
visit	trip	journey	
believe	say	consider	
income	investment	
exploration	management	development	
wants	knows	says	believes	
provincial	municipal	federal	
campaign	draft	record	test	
freestyle	cwt	
pairs	rounds	shots	
concrete	wooden	glass	interior	
face	right	
usual	precise	exact	
ideas	ways	
concern	claims	concerns	
enough	impossible	
calling	holding	telling	
tanks	guns	
starts	begins	continues	
girl	woman	teenager	couple	man	boy	
either	simply	merely	
manufacturers	products	
caused	resulted	suffered	
raid	bombing	bomb	crash	
sheet	vault	chain	burst	barrel	
with	behind	thanks	
star	group	band	fan	
holiday	fair	weekend	
service	services	training	offices	
gearbox	humanitarian	
promise	hope	wish	
striker	spokesman	defender	
downgraded	warrants	
hair	skin	eye	
productive	stable	
experience	impact	effect	focus	
sessions	meetings	
something	everything	
inquiry	investigation	investigations	
permission	responsibility	duties	
finished	left	
hailed	welcomed	praised	
remarkable	excellent	elaborate	
morning	evening	day	night	
exit	fill	
scoreline	worsened	
casualties	survivors	deaths	victims	
inside	outside	
killer	dog	virus	detective	
cover	block	use	
meet	serve	follow	hold	
exposure	care	treatment	
districts	provinces	states	
favoured	clot	
council	union	government	court	party	
figures	names	books	stories	
making	taking	giving	
versus	mosque	
consolation	reelection	
promising	failing	
championships	championship	finals	cup	
vault	sheet	barrel	
bottom	top	edge	
site	location	facility	
defends	shattered	
serve	meet	follow	hold	
tomb	palace	
elephant	bat	stick	
world	city	
research	studies	laboratory	scientific	
den	compound	van	der	
stadium	club	pool	
closely	widely	strongly	
complex	central	
fellow	friend	
highway	railway	
desk	room	window	
must	could	might	can	may	would	will	should	
wooden	concrete	glass	
strategy	factor	movement	
locomotive	balloon	
definitely	hardly	certainly	
secretary	president	mayor	governor	minister	
crude	tomato	garlic	hairy	
perhaps	indeed	
students	members	teachers	
counterpart	goalkeeper	
knee	rallies	
conduct	exercise	
vast	massive	huge	
meat	bread	sheep	corn	rice	
location	site	course	
feared	persuade	
name	title	
ball	spot	hole	
communications	technology	software	
nations	countries	
training	services	service	
increased	refined	reduced	improved	
outcome	situation	possibility	problem	
unsuccessful	successful	
period	era	century	
released	directed	
claims	concern	concerns	
require	provide	
human	religious	social	
from	between	
rider	riders	
complaint	whales	
direct	complete	
protests	incidents	
reflected	expressed	indicated	
methods	sources	levels	factors	
could	must	might	can	shall	would	did	will	should	
love	life	interest	
videos	interviews	magazines	newspapers	
box	bonus	card	
stood	came	remained	stayed	
popular	common	traditional	
dealt	resolved	
drugs	babies	drug	
immediately	instead	
executed	ordered	gathered	
known	named	called	
draft	campaign	signing	record	test	
rather	less	more	
bat	elephant	stick	
lending	commitments	
technical	key	basic	practical	
guide	link	
wrist	stomach	chest	skull	
ranks	sides	
today	still	
best	first	last	
opening	starting	closing	
meetings	sessions	
personal	physical	
satisfied	reluctant	sure	
gun	firing	shooting	
employed	engaged	trained	
stomach	wrist	chest	skull	mouth	
expansion	growth	
friend	fellow	brother	
status	rights	origin	
signs	tests	measures	trials	
suggesting	considering	indicating	
failure	withdrawal	loss	
winter	spring	summer	
commitment	contribution	
telephone	digital	computer	
defender	spokesman	striker	
reaction	response	
chronic	healthy	mild	severe	
engaged	employed	trained	
legislature	constitution	
sentenced	convicted	murdered	
link	guide	connection	
expenses	gasoline	
break	fall	
urgent	immediate	
beyond	via	through	toward	towards	
buyers	four-hour	
signing	draft	
mixed	della	
penalty	sentence	
gunfire	miracle	
prepared	ready	
reject	infringement	
surge	wave	
entire	same	original	
trio	incentives	bowler	
came	stood	ran	went	stayed	
higher	greater	low	high	lower	
strategist	fined	
really	n't	
little	great	
block	cover	use	
copies	volumes	papers	
pray	hang	
feet	eyes	legs	
share	offer	shares	
behind	with	thanks	
wounded	injured	
enters	opens	returns	
escaped	fled	
trucks	prediction	
told	heard	
positions	posts	movements	
university	school	college	campus	
task	plan	mission	
river	sea	mountain	tree	forest	
obligations	provisional	
mood	pain	
friendly	skilled	fierce	
beef	sexually	
check	charge	
dangerous	safe	violent	bloody	
cast	put	cut	
but	nor	because	
forecast	delayed	
refugees	civilians	
language	culture	
cotton	tobacco	cattle	
expand	strengthen	operate	
married	born	
both	those	
parent	baby	
reports	records	
miracle	gunfire	
slumping	serie	
band	group	star	
hours	seconds	months	weeks	days	minutes	
helicopter	staff	crew	
reported	observed	confirmed	suggested	
values	differences	
house	bank	
buy	sell	
bonus	box	card	
receiving	demanding	seeking	
fair	holiday	weekend	
gasoline	expenses	
year	season	
challenge	contest	
paint	trim	smoke	
looked	seemed	proved	
justice	freedom	
oil	gas	fuel	jet	
coming	going	setting	
wars	war	rebellion	
defeated	fought	
rates	limits	costs	
servant	citizen	lady	princess	
platform	network	
surgery	therapy	
near	nearby	
hog	dishonest	
pressure	tension	
express	watch	
drove	fell	broke	
safety	emergency	relief	preparation	
domestic	ethnic	
fans	players	teams	games	
slight	striking	stiff	sharp	
clot	favoured	
say	believe	consider	mean	claim	
effort	improvement	
controversial	widespread	
policemen	missionary	
influx	malaria	
willing	concerned	interested	
months	hours	weeks	times	days	minutes	
eastern	northern	southern	western	
champion	coach	
fast	hard	fresh	
program	programme	model	project	
gold	bronze	silver	seed	
running	leading	playing	
met	reached	entered	
corruption	violence	
hoped	decided	insisted	
than	exactly	
specified	fixed	
investigate	explain	discuss	
families	persons	relatives	
van	den	der	
committed	informed	
minute	month	hour	
speaking	publishing	writing	reading	
propaganda	weapons	security	intelligence	
follow	meet	serve	hold	
famous	home	old	
fundamental	so-called	
helicopters	pressed	
tag	southeastern	
congress	parliament	
final	third	second	
far	too	part	
general	military	
wait	fix	hurry	
significant	outstanding	substantial	
volume	distribution	output	
groups	institutions	
jail	custody	prison	
county	district	
date	show	play	
violence	corruption	
least	most	
mental	emotional	spiritual	romantic	
might	must	could	can	would	will	should	
threat	danger	
wing	defensive	front	
pellets	gloom	
sources	methods	factors	
difficulties	effects	problems	difficulty	
breakdown	voter	
towed	yarn	buggy	
dealing	gathering	searching	
dog	killer	
champions	winners	winner	
relatively	very	extremely	fairly	highly	
office	board	charge	
develop	improve	
serving	joining	
knew	insisted	
obsessed	tired	reluctant	confident	
whether	how	what	why	
each	every	
money	cash	
extortion	justified	
paying	selling	spending	
initiative	organisation	
product	source	
hear	tell	
rise	collapse	transition	
faster	slow	
container	bulk	
kept	pulled	waved	picked	caught	
middle	past	upper	
front	wing	
immediate	urgent	
proposal	statement	
collapse	rise	drift	
critic	composer	scientist	
especially	particularly	
initial	overall	previous	
talks	visits	
push	move	stretch	pull	
call	sign	
grand	royal	
know	want	think	
bounce	swing	
going	coming	setting	
source	product	
posts	positions	
territory	border	
year-end	coconut	ours	
formally	officially	
hardly	definitely	certainly	
situation	outcome	difference	possibility	problem	
consider	believe	say	
unions	parties	
flat	straight	narrow	
well	quite	
certainly	indeed	definitely	hardly	
showed	drew	
hundred	million	billion	
cricket	soccer	rugby	football	tennis	sports	
homes	farms	markets	
larger	smaller	separate	
mean	say	
union	council	government	court	
regular	full	
compassion	sympathy	
contracts	funds	
drawn	tied	
savings	investment	financing	debt	
replaced	removed	
effects	difficulties	problems	
responsible	involved	
pushed	dropped	stopped	
coalition	federation	
terror	suicide	
corporate	global	collective	
seems	indicates	
radical	conservative	liberal	
convicted	sentenced	murdered	
rally	feeder	sprint	
free	foreign	local	private	
muscle	muscular	sweat	tissue	
foot	shoulder	leg	
prior	following	
monthly	weekly	daily	
them	him	
ones	seeds	
operator	package	holder	manufacturer	
performance	success	quality	
warning	hearing	
comments	calls	questions	
roughly	nearly	virtually	
sensitive	unwanted	conscious	
joint	permanent	temporary	
five	four	seven	nine	three	eight	six	two	
remove	protect	replace	
bad	good	real	
sluggish	withering	receding	
round	flag	pole	
security	propaganda	intelligence	
owners	owner	workers	
president	secretary	mayor	governor	minister	
minimum	maximum	total	
severely	badly	seriously	
month	minute	hour	
div	brilliant	
sad	happy	tense	
hands	heads	eyes	legs	
example	exception	
steel	plastic	rubber	
education	health	
strategic	global	collective	
strokes	crashed	
hinterland	self-rule	sovereignty	
persons	families	cases	relatives	
names	figures	stories	
marks	dates	points	
gestures	citing	
brings	manages	leads	meets	
strained	troubled	
denounced	washed	
match	spell	finish	
priority	entry	
sea	river	mountain	mass	
rain	storm	heat	weather	wind	
belongs	belonging	
doctors	patients	
women	girls	boys	people	men	
common	popular	traditional	
claimed	stated	
depressed	guaranteed	
cases	persons	
eye	skin	hair	
substituted	bankruptcy	
tap	touch	
wall	tower	yard	floor	plane	
worldwide	overseas	
unite	elect	
comes	goes	
quiet	busy	
coups	handgun	
north	west	south	east	
waste	mine	
immigrants	immigration	residents	
spirits	whites	
malaria	influx	
independent	existing	exclusive	ordinary	
lows	trader	
kuna	umpires	
respect	understanding	
hunting	fishing	farming	
fail	expect	happen	
healthy	chronic	severe	long-term	
father	daughter	wife	husband	brother	mother	son	
studies	research	laboratory	
bring	lose	save	keep	
border	territory	coast	shore	
fate	spite	truth	
hard	fast	fresh	
firing	gun	shooting	
number	series	
direction	way	position	
flying	troop	landing	
tests	signs	measures	trials	
dollar	pound	yen	
developed	focused	
quarters	yards	
compliance	photographed	
plus	respectively	
shoot	catch	fly	
hurts	overthrow	
double	standard	single	
sugar	corn	
conference	convention	
initiated	conducted	
several	other	various	
baby	parent	
walking	travelling	
reached	met	entered	
dry	wet	
demand	purchase	pay	
itself	themselves	means	
visitors	passengers	
ill	painful	conscious	
bronze	gold	silver	seed	
director	manager	
dollars	yen	
woman	girl	teenager	couple	man	boy	
lift	drop	
wife	daughter	father	husband	brother	girlfriend	mother	son	
weekend	holiday	fair	
manufacture	export	
certain	multiple	specific	different	
failed	lost	
trial	sentence	
value	size	
player	club	team	
province	nation	suburb	colony	
unclear	supposed	unlikely	
illness	diet	disease	inflammation	infection	
transport	transportation	
function	form	
lady	servant	princess	
mainly	mostly	locally	
concluded	confirmed	cited	indicated	suggested	
supporters	leaders	opponents	
players	fans	teams	games	
multiple	certain	specific	different	
controversy	protest	debate	criticism	
factory	farm	company	garden	
soccer	cricket	rugby	football	golf	tennis	
containing	using	
found	discovered	recovered	
venture	ship	port	
bishop	king	
crowd	venue	
elections	election	
laboratory	research	studies	
took	gave	
treaty	declaration	
partner	member	
coast	border	shore	
king	bishop	
gap	pace	
cushion	kick	snap	
welcomed	hailed	praised	
federation	coalition	
tired	obsessed	reluctant	confident	
carry	perform	
event	festival	calendar	
three-year-old	balloting	
tension	pressure	
relations	reconciliation	
insisted	hoped	knew	
internal	physical	
contests	upstairs	
banks	wells	mines	
loose	tight	stiff	sharp	
everything	something	everyone	
reasons	incidents	
commander	officer	leader	captain	
involvement	colleagues	intervention	
plants	fields	bacteria	
visits	talks	
pulled	kept	waved	picked	caught	
key	technical	basic	
home	famous	old	
catch	shoot	fly	feed	
tested	delivered	
perform	carry	
stations	tracks	
row	string	pattern	
split	run	set	
denote	penalties	
trade	business	exchange	
ranked	nominated	
goal	objective	intent	
payment	revenue	tax	compensation	
soldiers	prisoners	fighters	troops	
close	long	short	
plant	store	
outstanding	significant	substantial	
economist	defenders	
tour	concert	
march	session	schedule	
management	exploration	development	
remained	stood	proved	
outside	inside	
often	generally	traditionally	normally	regularly	sometimes	
membership	recognition	participation	
filled	covered	surrounded	
programme	program	model	project	
hanging	standing	sitting	
place	hand	
relatives	families	persons	
entertaining	excellent	elaborate	
selected	completed	
monitoring	reporting	planning	testing	
recover	negotiate	seize	withdraw	
rescued	confusing	
long	close	short	
ranking	sentences	
model	program	programme	project	
military	general	naval	defence	civilian	
missed	scored	wins	
past	middle	rest	
listed	registered	
units	systems	
foreign	free	local	private	
fishing	hunting	mining	farming	
how	whether	what	why	
our	your	
card	box	bonus	
installed	delivered	
persuade	feared	
concerning	regarding	involving	
remain	become	
starter	treating	
operated	opened	served	built	located	
preliminary	recommendation	
base	target	
prime	deputy	chief	
real	future	good	bad	
causing	removing	
structured	packed	
shutdown	lifted	
mayor	secretary	president	governor	minister	
circumstances	conditions	
stabbed	pistol	
record	campaign	draft	test	
walk	climb	pass	
photographed	compliance	
difference	situation	problem	
doctor	surgeon	nurse	
broad	wider	narrow	
secure	costly	
senior	junior	founding	
resolution	delay	
eventually	soon	finally	
depending	ranging	closer	
cow	giant	
offers	holds	provides	
weapon	rifle	
tight	loose	uneven	stiff	
sign	call	
member	partner	
ran	came	got	went	
tomato	crude	garlic	hairy	
earlier	later	
concerned	willing	interested	
watch	express	train	
procedure	case	condition	
scored	missed	wins	
recovered	discovered	found	
naval	nuclear	military	civilian	
short	close	long	
buyer	employee	customer	
strikeouts	dozen	
piece	pair	lot	bit	
had	have	has	
fourth	seventh	sixth	fifth	
copy	picture	
fact	reason	
chance	luck	time	
flights	buses	passengers	
just	once	
technology	communications	software	
only	then	
pure	simple	
festival	ceremony	event	calendar	resort	celebration	
items	materials	computers	
criminal	illegal	secret	terrorist	crime	police	
operation	operations	supplies	
designed	used	
what	whether	how	why	
giant	cow	
explained	revealed	noted	described	
session	march	schedule	
withering	sluggish	receding	swift	
expanding	continuing	developing	
spiritual	emotional	mental	
price	cash	
exactly	than	
lifted	shutdown	
insistence	stance	
life	love	interest	
wounds	warnings	pitches	
insurance	sales	
targeted	organised	distributed	
organisations	programmes	centers	
way	direction	position	
traditionally	generally	often	normally	sometimes	
sides	ranks	
capture	sleep	escape	
midday	noon	
beat	kick	
four-hour	buyers	
notice	request	
babies	drugs	brains	
employees	customers	workers	
others	friends	people	children	
board	office	
fraud	theft	
devices	equipment	
financial	economic	
diet	illness	disease	treatment	
plastic	steel	rubber	
preferred	chosen	
distribution	volume	output	
gathering	dealing	searching	
northeast	southwest	southeast	northwest	
road	station	
grenades	ultimatum	
uses	controls	cuts	
every	each	
brains	babies	
grant	post	patent	
can	must	could	might	may	would	does	will	should	
back	off	down	
retained	changed	secured	
cargo	freight	passenger	ferry	
dominated	emerged	
followed	held	
talk	live	
militant	cycling	
entertainment	comics	films	fun	
concerns	concern	claims	
shoulder	foot	leg	
getting	helping	doing	trying	
grade	class	
expensive	easy	
rupiah	declines	
whales	complaint	
carries	holds	leads	serves	
scores	numbers	statistics	
manager	director	
leading	running	moving	
resulted	caused	suffered	
held	followed	
muscular	muscle	sweat	tissue	
fear	sympathy	
paper	text	word	
striking	slight	sharp	
headed	joined	moved	transferred	
shift	transition	change	
trip	visit	journey	
late	early	beginning	
treat	urge	
industry	market	
whites	spirits	
der	compound	den	van	
though	however	
deals	sets	
walks	spots	
demanding	receiving	seeking	
revenue	credit	payment	compensation	
survivors	casualties	deaths	victims	
suspended	charged	
bases	planes	bodies	targets	
slept	pulp	
wanted	tried	
customers	jobs	employees	
widely	closely	strongly	
kick	cushion	beat	snap	
dishonest	hog	
mild	chronic	severe	
reduction	regulation	
insider	lawsuits	
better	difficult	
orders	instructions	
conflict	dispute	conflicts	chaos	
knows	wants	feels	tells	says	believes	
parties	unions	
injury	injuries	
taking	making	giving	
outline	background	image	
pattern	string	row	
begins	starts	continues	
subsequently	initially	
tax	payment	compensation	
spring	winter	summer	
hope	promise	wish	
fill	exit	
starting	opening	finishing	closing	
strict	formal	
generation	factor	formula	
entering	returning	
white	black	dark	red	
lives	lived	
scientists	researchers	experts	
bypass	promptly	
while	when	where	
forces	strikes	
conversion	transmission	noise	
digital	electronic	telephone	computer	
emergency	safety	relief	
reputation	retirement	career	
she	they	
led	included	
drew	showed	
informed	committed	
compensation	payment	revenue	tax	
brilliant	div	
ballot	voting	
ministers	representatives	
extraordinary	mutilated	
wet	dry	
officer	commander	leader	captain	
nature	knowledge	importance	
ending	breaking	
third	final	second	previous	
transportation	transport	electricity	
bills	seats	
growth	expansion	
ready	prepared	
fight	struggle	defeat	victory	
launching	bondholders	
indicating	considering	suggesting	
sweep	haul	halt	
impossible	enough	
green	blue	bright	yellow	
church	grounds	residence	
control	support	contact	
chest	wrist	stomach	skull	
bought	sold	owned	
schools	churches	
system	framework	basis	
ultimatum	grenades	
shooting	gun	firing	
data	information	
rich	growing	
success	performance	quality	
seven	four	five	nine	eight	six	
sporadic	solitary	unspecified	
flows	flow	
carefully	clearly	
wider	broad	narrow	
decide	try	
guns	tanks	
batter	starved	
evening	morning	night	
raised	carried	
offices	services	service	
benefits	costs	cost	
killing	breaking	
compromise	guarantee	
murdered	sentenced	convicted	
pace	gap	
bonds	partners	
dirty	mad	
romantic	emotional	mental	
handgun	coups	
was	were	became	
monarch	crown	
railway	highway	
shirt	collar	
beer	liquor	bread	
output	volume	distribution	
currency	stock	
strengthen	establish	expand	restore	
ground	surface	soil	
ratio	margin	rate	
painful	ill	conscious	
greater	higher	low	high	lower	
edged	fertiliser	
test	campaign	draft	record	
finally	eventually	
lived	lives	settled	
championship	championships	finals	cup	tournament	
believed	considered	thought	
leaves	falls	
low	higher	greater	high	lower	
predominantly	mostly	locally	
heavily	partly	largely	
yield	estimate	measure	
husband	daughter	father	wife	brother	girlfriend	mother	son	
spending	selling	paying	
paid	offered	
pain	blood	mood	breathing	
magazine	journal	publication	book	
representatives	ministers	
capital	property	
collar	shirt	
cool	clean	
planning	reporting	monitoring	testing	
religious	human	social	
blue	green	yellow	
fought	defeated	
earned	gained	
goalkeeper	counterpart	
plan	task	mission	
lead	release	
disarmament	terrorist	
ban	ruling	
now	still	
pitches	wounds	
freight	cargo	passenger	ferry	
parts	elements	
swimmer	mate	
parliamentary	legislative	presidential	judicial	electoral	diplomatic	
ethnic	domestic	
threats	crimes	
failing	promising	losing	
materials	items	
following	prior	
opens	enters	follows	
retirement	reputation	career	
seat	bar	
mutilated	extraordinary	heroin	
use	cover	block	ease	
lowered	reduced	
without	under	
leader	candidate	commander	officer	captain	
historic	coastal	rural	
individual	specific	particular	
ticket	bus	taxi	
work	works	
garlic	crude	tomato	hairy	
fined	strategist	
disagreement	violation	
era	period	century	
slow	faster	
immigration	immigrants	residents	
clearly	carefully	strongly	
purposes	facilities	
typical	rare	
low-lying	moisture	
fan	star	solo	
head	body	
spell	match	finish	
singer	producer	
straight	flat	narrow	
citing	gestures	
secret	illegal	criminal	police	
cap	unit	carrier	
throwing	beating	
hopes	demands	
war	wars	rebellion	exile	
planes	bases	bodies	targets	
heart	brain	
overall	initial	
finding	showing	representing	
manages	brings	meets	
participants	tasks	
target	base	
stable	productive	weak	stronger	
rest	past	
sets	deals	points	
professional	specialist	
displayed	painted	
normally	generally	often	traditionally	sometimes	
included	led	produced	introduced	
helping	getting	doing	trying	
prayer	meal	birthday	
brother	daughter	friend	father	wife	husband	son	
feels	knows	says	believes	
follows	opens	meets	
struck	dropped	
indicates	seems	
spate	promptly	
brief	repeated	
through	via	into	beyond	toward	
bone	tissue	gene	
computer	electronic	telephone	digital	
speech	suspension	motion	
operate	expand	extend	
broken	battered	empty	fallen	
hired	retired	
finishing	starting	miss	
leads	brings	carries	
interview	review	
swing	bounce	
supplies	operations	operation	
linked	related	distributed	identified	
blank	voices	
young	former	
requirements	options	standards	
speaker	cabinet	
choose	compete	
reliever	medallist	
delight	insight	
snap	cushion	kick	
try	decide	
style	dialogue	character	
room	desk	floor	window	
dialogue	style	character	
leg	foot	shoulder	
quarter	mile	
when	while	where	
years	decades	times	days	
testing	reporting	monitoring	planning	
shore	border	coast	
stated	claimed	
lost	failed	
most	least	many	
framework	system	basis	
existing	independent	exclusive	ordinary	
dates	marks	points	
legislative	parliamentary	presidential	judicial	electoral	
otherwise	longer	
died	survived	
measures	signs	tests	
field	reserve	
provisional	obligations	
century	period	era	
expect	fail	happen	
lawyer	businessman	
places	houses	
directed	released	
comics	entertainment	films	
bright	green	yellow	
batches	pumps	
temporary	permanent	joint	
surprise	swift	
chosen	preferred	
skilled	friendly	fierce	
closed	operating	scheduled	
delivery	recovery	storage	
latest	worst	greatest	biggest	own	
find	eat	
resolved	dealt	
deliver	distribute	
brawl	racket	
captain	commander	officer	leader	
despite	due	
glass	concrete	wooden	
miss	finishing	
hotel	restaurant	
million	hundred	billion	
determined	intended	
representing	showing	finding	
dividend	payable	inflation	liquidity	discount	
storm	rain	heat	wind	
market	industry	
scoring	winning	
obtained	provided	received	
maker	racket	dealer	
two-thirds	lagged	
dropped	pushed	struck	picked	stopped	caught	
belonging	belongs	
understanding	respect	
confirmation	prostitutes	
forma	unwinding	
take	give	
drinking	eating	
stick	elephant	bat	
reform	independence	
considered	believed	thought	
fields	plants	
west	north	south	east	
write	speak	read	
discuss	explain	investigate	
sell	buy	
bacteria	plants	
fix	wait	hurry	
suspect	suspected	
banking	trading	
enter	spend	
commission	committee	
changing	moving	reverse	
massive	vast	huge	
stance	insistence	
defeat	struggle	fight	victory	
background	outline	image	
financed	funded	
small	large	
choice	confidence	
nurses	forensic	
junior	senior	
developments	programmes	projects	
were	was	became	
beaten	thrown	
personnel	officials	officers	
breaking	rising	ending	killing	falling	
points	marks	sets	dates	
nor	but	because	
however	though	
passage	tunnel	route	trail	crossing	
bombing	raid	bomb	crash	
precise	underlying	usual	exact	
hot	ice	big	
bulk	container	
text	paper	word	
library	department	bureau	
trim	paint	smoke	
cabinet	speaker	
maximum	minimum	total	
gas	oil	fuel	jet	
movements	positions	
brain	heart	nervous	
seriously	badly	severely	
weeks	seconds	hours	months	days	minutes	
motor	vehicle	
story	book	
provided	obtained	received	
package	operator	holder	manufacturer	
pneumonia	unsure	
investing	conviction	
shall	could	would	should	
showdown	opposes	
everyone	everything	someone	
rugby	cricket	soccer	football	tennis	
ranging	depending	closer	
effectively	quickly	
bodies	bases	planes	targets	
reluctant	satisfied	obsessed	tired	confident	
nothing	too	
kills	strikes	
harvest	export	crop	drought	
surface	ground	soil	
still	today	now	never	
some	these	none	
position	direction	way	
weak	stable	dominant	stronger	
this	one	
game	tournament	
confident	obsessed	tired	reluctant	
specialist	professional	
leaders	supporters	opponents	
equipment	devices	
solo	fan	
politician	lunches	
central	complex	
south	north	west	east	
second-longest	sufficiently	
plot	scene	search	
prediction	trucks	
trophy	cup	prize	medal	
unc	jailed	
delay	resolution	
defenders	economist	
terrorist	criminal	disarmament	
partly	heavily	largely	
inflation	dividend	liquidity	discount	
speak	write	read	
bondholders	launching	
ordered	executed	gathered	
figure	bill	mark	note	
legal	public	political	
mad	dirty	
trials	signs	tests	
stretch	push	
mile	quarter	
erupted	doubts	
shut	removed	
left	finished	
mainland	neighbouring	
too	far	nothing	part	
case	procedure	condition	matter	
that	which	
partial	continuous	rapid	
population	settlement	region	
medicine	medical	
refined	increased	improved	
likely	possible	necessary	
charge	check	office	
negative	consistent	positive	
seek	pursue	
crown	monarch	
hold	meet	serve	follow	
may	must	can	will	
seeking	receiving	demanding	
claim	say	
transition	rise	shift	change	
cash	money	price	
incentives	trio	
pictures	photographs	
unwinding	forma	
seize	negotiate	recover	withdraw	
rebel	rebellion	exile	
during	throughout	
improve	develop	reduce	
extreme	cold	
traffic	transit	rail	
formal	strict	
controls	uses	cuts	
details	documents	
other	several	various	
fuel	oil	gas	jet	
prisoners	soldiers	civilians	troops	
tolerance	weakness	stability	discrimination	
mountains	islands	
standing	hanging	sitting	
competitive	competing	
toss	pick	
got	ran	went	
dispute	conflict	conflicts	chaos	
fighters	soldiers	troops	
winds	waters	
television	media	radio	news	
rapidly	quickly	slowly	
helps	does	
programmes	organisations	developments	projects	centers	
lunches	politician	
such	including	
sold	bought	owned	
worst	latest	greatest	biggest	
conducted	initiated	
estimated	expected	
heirs	payments	
chain	sheet	
extremely	very	relatively	highly	
journey	visit	trip	
tower	wall	yard	plane	
yarn	towed	buggy	
firms	companies	investors	
starved	batter	
material	sound	
initially	subsequently	
themselves	itself	means	
deaths	casualties	survivors	victims	
volumes	copies	papers	
eating	drinking	
using	containing	
officials	personnel	officers	guards	
feeling	suffering	
proportion	percentage	majority	
elect	unite	declare	
specify	fertiliser	
exception	example	majority	
fed	destroyed	damaged	burned	
metres	miles	
systems	units	
these	some	none	
your	our	
need	lack	help	
bankruptcy	substituted	
exclude	deny	submit	
duties	responsibility	permission	
bottle	hole	
bus	ticket	taxi	
route	tunnel	passage	trail	crossing	
buggy	towed	yarn	
disease	illness	diet	treatment	
cross	flag	
severe	chronic	healthy	mild	
smaller	larger	separate	
largest	highest	greatest	biggest	
huge	vast	massive	
governor	secretary	president	mayor	minister	
riding	driving	
commitments	lending	
specific	certain	multiple	individual	particular	
journal	magazine	publication	book	
sought	turned	brought	
thing	person	
great	little	
run	split	set	
farmers	farms	
luck	chance	
completed	selected	scheduled	
including	such	
plays	shows	
facility	site	
northern	eastern	southern	
publication	magazine	journal	book	
hand	place	side	
returns	enters	goes	
populist	trends	
family	male	child	
hang	pray	
endorsement	recognition	
old	famous	home	
silver	gold	bronze	seed	
mountain	river	sea	forest	
rights	status	origin	
tobacco	cotton	cattle	
formed	represented	
preference	blast	
relief	safety	emergency	preparation	
notes	wrote	spoke	
payments	heirs	
medical	health	medicine	drug	
organised	targeted	
singles	matches	
rebellion	wars	war	rebel	exile	
its	the	their	
fatal	refusing	
standard	double	single	equivalent	
washed	denounced	
pair	piece	bit	
demanded	tried	refused	promised	
building	maintenance	construction	
reduced	increased	lowered	improved	
live	talk	
would	must	could	might	can	shall	did	will	should	
cooperation	friendship	
cities	towns	settlements	
ship	venture	port	
nominated	ranked	
simply	either	merely	
less	rather	more	
delivered	tested	installed	
expected	estimated	
port	venture	ship	
seen	shown	
solution	device	
began	started	
rubber	steel	plastic	
square	corner	
extended	restored	
incidents	protests	reasons	
bush	whale	
did	could	would	does	
related	linked	identified	
opponents	supporters	leaders	
bread	meat	beer	corn	rice	
unspecified	solitary	sporadic	
local	free	foreign	private	
works	work	
nine	four	five	seven	eight	six	
fiancee	depart	
shot	hit	
sentence	penalty	trial	
rare	typical	
public	legal	
thanks	with	behind	
school	university	college	campus	
feel	look	
skull	wrist	stomach	chest	
losing	failing	
restaurant	hotel	
halt	haul	sweep	
wells	banks	mines	
links	ties	views	
providing	creating	
investment	income	savings	
tracks	stations	
power	resistance	
farm	factory	garden	
purchase	demand	pay	
uneven	tight	
ensure	prevent	maintain	reduce	
gathered	executed	ordered	scattered	
waters	rocks	winds	
bill	figure	mark	note	
spot	ball	hole	
bones	dogs	clothes	
effective	costly	
damaged	destroyed	fed	burned	
girlfriend	wife	husband	
closer	depending	ranging	
problems	difficulties	effects	
mine	waste	
violent	dangerous	bloody	
teenager	girl	woman	couple	
unit	cap	machine	carrier	
pullout	interbank	
carried	raised	made	
went	came	ran	got	stayed	
production	stock	
none	some	these	
second	final	third	
early	late	beginning	
camp	meeting	hunt	
fairly	very	relatively	slightly	quite	
side	hand	
top	bottom	edge	
tried	wanted	demanded	refused	
finals	championships	championship	cup	
objective	goal	intent	
humans	birds	
factor	strategy	generation	formula	
cycling	militant	
judges	laws	rules	
doing	getting	helping	trying	
day	morning	night	
winner	winners	champions	
present	open	subject	
mutual	potential	
liquidity	dividend	inflation	discount	
registration	recognition	
denied	requested	
doubt	explanation	
form	function	
lack	need	help	
staff	helicopter	crew	
birthday	meal	prayer	
facilities	purposes	sites	
force	battle	
possibility	idea	outcome	situation	problem	
princess	servant	lady	
put	cast	cut	
gets	fails	
breathing	pain	
basis	system	framework	
grounds	church	residence	
restored	extended	
main	original	
crashed	strokes	
giving	making	taking	
opportunity	option	
holder	operator	package	manufacturer	
declaration	treaty	
pull	move	push	
represent	indicate	
why	whether	how	what	
funds	contracts	
funded	financed	
not	never	
frequent	recent	
flag	round	cross	pole	
papers	copies	volumes	
lot	piece	bit	
limits	rates	
defence	military	combat	
dark	black	white	red	
student	youth	
does	can	helps	did	
negotiations	proposals	
truth	spite	fate	
rating	net	
similar	limited	
existed	happened	occurred	
spared	vicious	
scientific	research	conservation	environmental	
indicate	represent	
happened	existed	occurred	
stayed	stood	came	went	
yields	revolt	
freedom	justice	
published	written	recorded	
heads	hands	eyes	
trampled	priced	
serves	holds	carries	includes	
militia	occupation	
basic	technical	key	practical	
vice	outgoing	
leave	stay	
soil	ground	surface	
noon	midday	
land	property	
bomb	raid	bombing	crash	
government	council	union	
returned	entered	sent	
tradition	history	
dominant	powerful	strong	weak	
virus	killer	
ease	use	
moves	ends	turns	runs	
valid	clear	reasonable	
yellow	green	blue	bright	
residents	immigrants	immigration	
village	town	city	island	
nation	province	colony	
project	program	programme	model	
town	village	city	island	
international	official	national	
touch	tap	
fertiliser	edged	specify	
crew	helicopter	staff	
definitive	first-round	
normal	high	
loan	budget	debt	
observed	reported	confirmed	
occurred	existed	happened	
investors	firms	
eighth	seventh	sixth	
kill	eat	
secession	extremist	
projects	developments	programmes	
moisture	low-lying	
business	trade	
track	drive	
fierce	friendly	skilled	tough	peaceful	
narrow	flat	broad	wider	straight	
cup	championships	championship	trophy	finals	
recovery	delivery	storage	
trading	banking	
change	shift	transition	
stronger	stable	weak	
department	library	bureau	
instead	immediately	
desperate	voiced	
stages	seasons	
care	exposure	treatment	
show	date	play	
computers	items	
seemed	looked	proved	
suburb	province	colony	
missionary	policemen	
books	figures	stories	
remote	isolated	
revealed	explained	noted	described	
umbrella	organisation	
nationality	pulp	
sense	perspective	
two-time	punches	one-day	
physical	personal	internal	
particular	individual	specific	
prostitutes	confirmation	
rules	laws	judges	
sympathy	compassion	fear	
tree	river	forest	
stiff	slight	loose	tight	sharp	
mother	daughter	father	wife	husband	
robbery	badminton	
trust	fund	
birth	death	
save	lose	bring	keep	
begin	continue	
living	working	
part	far	too	
instructions	orders	
excellent	remarkable	entertaining	elaborate	
withdrawal	failure	loss	
conflicts	conflict	dispute	chaos	
transfer	load	
scene	plot	search	
joined	headed	moved	
limited	similar	
sector	organisation	
sweat	muscle	muscular	
riders	drivers	rider	
conservation	scientific	environmental	
greatest	latest	worst	largest	biggest	
fails	gets	
hour	minute	month	
withdrew	resigned	
saw	continued	
high	higher	greater	low	normal	lower	
reason	fact	
timetable	coaching	
forensic	nurses	
confusing	rescued	
received	obtained	provided	offered	
entered	met	reached	returned	
career	reputation	retirement	
tells	knows	says	believes	
confirmed	reported	concluded	observed	cited	suggested	
fresh	fast	hard	
hearing	warning	
priced	trampled	
economy	infrastructure	
partners	bonds	
busy	quiet	
cuts	uses	controls	
rapid	continuous	partial	
football	sport	cricket	soccer	rugby	tennis	sports	
forecasts	detained	
cause	result	
workers	owner	owners	employees	
exile	war	rebel	rebellion	
easy	expensive	
talking	pretty	
fled	escaped	
outbreak	incident	
those	both	
colleagues	involvement	intervention	
major	minor	
city	world	village	town	
food	cattle	
spots	walks	moments	
millions	hundreds	thousands	
dating	dated	
continuing	expanding	developing	
truck	car	driver	
stop	ride	train	
taxes	prices	
trained	employed	engaged	
girls	women	boys	men	
shown	seen	
producers	consumers	
ways	ideas	
impact	experience	effect	focus	
chief	deputy	prime	
includes	serves	
coach	champion	
image	outline	background	
unwanted	sensitive	conscious	
perspective	sense	
eve	demonstrations	
nervous	brain	
wins	missed	scored	
punches	two-time	
films	entertainment	comics	
written	published	recorded	
climb	walk	pass	
costs	rates	benefits	cost	
give	take	
civilians	refugees	prisoners	
noted	explained	revealed	described	
open	present	subject	
prevent	ensure	reduce	
edge	bottom	top	
settlement	population	
solid	thin	tiny	
class	grade	
intended	determined	
shares	offer	share	
waved	kept	pulled	
involved	responsible	
first-round	definitive	
confidence	choice	
survey	study	report	
billion	hundred	million	
street	beach	
badminton	robbery	
labour	welfare	law	
communist	socialist	
largely	heavily	partly	
youth	student	
pilot	host	
protect	remove	replace	restore	
setting	coming	going	
required	needed	
detective	killer	
goes	comes	returns	falls	
ruled	passed	
researchers	scientists	experts	
minor	major	
emerged	dominated	
estimate	yield	measure	
more	rather	less	
fly	shoot	catch	feed	
friends	others	children	
network	platform	space	
fires	debris	
eyes	feet	hands	heads	legs	
liberal	conservative	radical	democratic	
state	region	
saying	telling	
changed	retained	secured	
seventh	fourth	eighth	sixth	fifth	
lifting	cutting	
produced	included	introduced	
version	edition	
start	end	
served	opened	operated	
plantation	outspoken	
separate	larger	smaller	
settle	negotiate	withdraw	
grain	copper	lumber	
politicians	governments	
ties	links	views	
sheep	meat	rice	
boys	women	girls	men	
royal	grand	
requested	denied	
stock	currency	production	
being	becoming	
transit	traffic	rail	
someone	everyone	
heat	rain	storm	wind	
blown	gloom	
cargoes	omitted	
score	debut	
thousands	hundreds	millions	
various	several	other	
help	need	lack	
competing	competitive	
clear	valid	reasonable	
colony	province	nation	suburb	
joining	serving	
legs	feet	hands	eyes	
delayed	postponed	forecast	
founding	senior	premier	
exercise	conduct	
camps	sites	
lawsuits	insider	
houses	places	
earn	compete	
forward	off	down	
export	manufacture	harvest	crop	
practical	technical	basic	
born	married	
large	small	
corn	meat	sugar	bread	rice	
mark	figure	bill	note	
improvement	effort	
justified	extortion	
falls	leaves	goes	
review	interview	
origin	status	rights	
possibly	even	probably	
bringing	putting	keeping	
tough	fierce	
looking	worth	
says	wants	knows	feels	tells	believes	
suitable	easier	
outgoing	vice	
borders	lands	
golf	soccer	swimming	tennis	
recent	frequent	
hit	shot	
proposals	negotiations	votes	candidates	
keep	lose	bring	save	
contract	partnership	
sex	sexual	
toll	departure	
interior	concrete	
pulp	slept	nationality	
operating	closed	
buses	flights	boats	passengers	
turned	sought	brought	
dated	dating	
one-day	two-time	
commercial	retail	consumer	
pursuing	servants	
troops	soldiers	prisoners	fighters	
settled	lived	
car	truck	driver	
votes	voters	proposals	candidates	
publishing	speaking	writing	reading	
matches	singles	
since	until	
cut	cast	put	
distributed	targeted	linked	identified	
effect	experience	impact	
swimming	golf	
sales	credit	insurance	
tennis	cricket	soccer	rugby	football	golf	
given	taken	done	
centers	organisations	programmes	
submit	exclude	
balloting	perfectly	three-year-old	
levels	methods	factors	
three	four	five	eight	six	two	
continued	saw	
producer	singer	
death	birth	
passenger	cargo	freight	ferry	rail	
recognition	membership	endorsement	registration	participation	
receding	sluggish	withering	
planting	investigated	
seed	gold	bronze	silver	
upset	hurt	
guaranteed	depressed	
pound	dollar	yen	
declines	rupiah	
collective	global	corporate	strategic	
nurse	surgeon	doctor	
economic	financial	
empire	republic	kingdom	
scattered	gathered	
weakness	tolerance	stability	
happy	sad	tense	
never	still	not	
corner	square	
mouth	stomach	bed	
week-long	rainfall	
word	paper	text	
feeder	rally	sprint	
focus	experience	impact	
ferry	cargo	freight	passenger	
municipal	provincial	federal	
secured	retained	changed	
load	transfer	
until	before	since	
exchange	trade	
couple	girl	woman	teenager	
red	black	white	dark	
telling	calling	saying	
beginning	late	early	
voter	breakdown	
investigated	planting	socialists	
connection	link	reference	
whale	bush	
growing	rich	
bit	piece	pair	lot	
video	film	
trouble	difficulty	
speculated	cwt	
identified	linked	related	distributed	
movement	strategy	
imposed	granted	
biggest	latest	worst	largest	greatest	
loss	failure	withdrawal	
device	solution	
consumer	retail	commercial	
ruling	ban	
stability	tolerance	weakness	
eight	four	five	seven	nine	three	six	
debris	fires	
opposes	showdown	
pole	round	flag	
jump	die	
moments	spots	
promptly	bypass	spate	
trying	getting	helping	doing	
faces	looks	
him	them	
bowler	trio	
thin	solid	tiny	
carrying	holding	
calendar	ceremony	event	festival	resort	celebration	
sixth	fourth	eighth	seventh	fifth	
products	manufacturers	
company	factory	firm	
garden	factory	farm	
taken	given	done	
doubts	erupted	
set	split	run	
gives	takes	makes	
recently	previously	
gave	took	
supposed	unclear	unlikely	
storage	delivery	recovery	
deposit	bond	
response	reaction	
formation	structure	
picked	kept	pulled	dropped	caught	
releases	hits	
removing	causing	requiring	replacing	
rice	meat	bread	sheep	corn	
islands	mountains	island	
nowhere	chances	
n't	really	
bid	vote	
sent	returned	
criticism	protest	debate	controversy	
repeated	brief	
private	free	foreign	local	
yard	wall	tower	plane	
district	county	
crime	criminal	
takes	gives	makes	
means	itself	themselves	
probably	possibly	
federal	provincial	municipal	
moving	leading	changing	
oil-for-food	villagers	
widespread	controversial	
issued	submitted	filed	
due	despite	
governments	politicians	
reelection	consolation	
mosque	versus	
under	without	
understand	explain	
burden	invading	
because	but	nor	
speculation	hampered	patrols	
team	club	player	
states	provinces	districts	
views	links	ties	
suspected	suspect	
discount	payable	dividend	inflation	liquidity	
character	style	dialogue	
members	students	teachers	
veteran	semifinalist	
overseas	worldwide	
phase	stage	
officially	formally	
interests	policies	
fall	break	
officers	personnel	officials	guards	
welfare	labour	law	
playing	running	
photographs	pictures	
countries	nations	
court	council	union	party	
official	international	national	
therapy	surgery	
die	jump	
weather	rain	wind	
crop	harvest	export	drought	
hanged	sic	
importance	knowledge	nature	
transmission	signal	conversion	noise	
fun	entertainment	
decades	years	times	
yen	dollar	dollars	pound	
provides	holds	offers	
guarantee	compromise	
machine	unit	carrier	
remaining	two	
title	name	
consumers	producers	
software	communications	technology	
shattered	defends	
man	person	girl	woman	boy	
titles	records	
organisation	initiative	umbrella	sector	
maintained	shared	supported	
moment	conclusion	
scheduled	closed	completed	
forcing	sending	
meant	needed	
incident	outbreak	
saving	preparing	putting	keeping	
spoke	wrote	notes	
size	value	
troubled	strained	
stopped	pushed	dropped	
built	operated	located	
reserve	field	
jumped	forehand	
option	opportunity	
marriage	divorce	
southern	eastern	northern	
rallies	knee	
venue	crowd	
presence	environment	
drift	collapse	
first	best	last	
below	per	
community	country	
demonstrations	eve	
people	women	others	children	
many	most	
caught	kept	pulled	dropped	picked	
crimes	threats	
series	number	
challenged	dismissed	
decisive	crucial	
point	level	
merely	either	simply	
surrender	command	
used	designed	
speed	weight	
prices	taxes	
support	control	contact	
maintain	ensure	
statistics	numbers	scores	
interest	love	life	
times	months	years	decades	days	
writing	speaking	publishing	reading	
granted	imposed	declared	
dismissed	challenged	
development	exploration	management	
heard	told	
bloody	dangerous	violent	
blocked	recommendations	
crash	raid	bombing	bomb	
presidential	parliamentary	legislative	electoral	diplomatic	
problem	outcome	situation	difference	possibility	
described	explained	revealed	noted	
inflammation	illness	infection	
burst	sheet	barrel	
barrel	sheet	vault	burst	
mission	task	plan	
southeast	southwest	northeast	northwest	
same	highest	entire	original	
demands	hopes	
republic	empire	united	
station	road	
tasks	participants	
bureau	library	department	ministry	establishment	
voices	blank	
toward	beyond	through	towards	
warrants	downgraded	
noise	signal	conversion	transmission	
intent	goal	objective	
charged	suspended	
resistance	power	
scientist	critic	
jet	oil	gas	fuel	
carrier	cap	unit	machine	
subject	present	open	
rail	traffic	transit	passenger	
hole	ball	bottle	spot	
working	living	
conscious	sensitive	ill	painful	unwanted	
racket	brawl	maker	dealer	
bed	mouth	
regularly	often	sometimes	
previous	initial	third	
boats	roads	buses	streets	
settlements	towns	cities	
motion	suspension	speech	
requiring	removing	replacing	creating	
margin	ratio	rate	
keeping	preparing	putting	bringing	saving	
meeting	camp	hunt	
electricity	transportation	
towards	beyond	toward	
covered	filled	
train	ride	watch	stop	
balloon	locomotive	
contact	control	support	
ours	year-end	
wind	rain	storm	heat	weather	
previously	ever	recently	
voting	ballot	
meets	brings	manages	follows	
named	known	called	
mate	swimmer	
serie	slumping	
winning	scoring	
humanitarian	gearbox	
regarding	concerning	involving	
off	back	forward	down	
pistol	stabbed	
detained	forecasts	
hunt	camp	meeting	
regime	pact	
consistent	negative	positive	
tournament	championship	game	
search	plot	scene	
law	labour	welfare	
western	eastern	
interbank	pullout	
six	four	five	seven	nine	three	eight	
sure	satisfied	
records	reports	titles	
investigations	investigation	inquiry	
condition	procedure	case	matter	time	
conviction	investing	
college	university	school	campus	
mostly	mainly	predominantly	locally	
standards	options	requirements	
possible	likely	necessary	
fifth	fourth	seventh	sixth	
clothes	dogs	bones	
rifle	weapon	
matter	case	condition	
owned	bought	sold	
sentences	ranking	
mining	fishing	farming	
east	north	west	south	
traditional	new	popular	common	
dying	battered	
documents	details	
civilian	nuclear	military	naval	
residence	church	grounds	
survived	died	
victory	fight	defeat	
formula	generation	factor	
prison	custody	jail	
instantly	quickly	repeatedly	slowly	
offered	paid	received	
targets	bases	planes	bodies	
pursue	seek	
floor	wall	room	
swift	withering	surprise	
then	only	
teams	fans	players	games	
fund	trust	
representative	executive	
independently	directly	
edition	version	
recommendation	preliminary	
property	capital	land	
battered	broken	dying	empty	
burned	destroyed	fed	damaged	
judicial	parliamentary	legislative	electoral	
empty	broken	battered	fallen	
provide	require	
markets	farms	homes	
refused	demanded	tried	promised	
request	notice	
returning	entering	
rate	ratio	margin	
kingdom	empire	
northwest	southwest	northeast	southeast	
vote	bid	
promised	demanded	refused	
schedule	march	session	
medium	wide	
invading	burden	
driver	truck	car	
battle	force	
his	her	
debut	score	
friendship	cooperation	
packed	penalties	structured	
farming	hunting	fishing	mining	
withdraw	negotiate	recover	seize	settle	
sometimes	generally	often	traditionally	normally	regularly	
ministry	bureau	establishment	
drop	lift	blow	
jailed	unc	
reference	connection	
suffered	caused	resulted	faced	
declare	elect	
construction	maintenance	building	
partnership	contract	
where	while	when	
risk	benefit	
involving	concerning	regarding	
expressed	reflected	
victim	victims	
elements	forms	parts	
retired	hired	
participation	membership	recognition	
called	known	named	
victims	casualties	survivors	deaths	victim	
falling	rising	breaking	
games	fans	players	teams	
pretty	talking	
will	must	could	might	can	may	would	should	
repeatedly	briefly	instantly	
threatened	forced	
exclusive	independent	existing	
son	daughter	father	wife	husband	brother	
vicious	spared	
post	grant	patent	
intelligence	weapons	propaganda	security	
slightly	fairly	quite	
tell	hear	
provision	implementation	
fallen	broken	empty	
electoral	parliamentary	legislative	presidential	judicial	diplomatic	
full	regular	
per	below	
coastal	historic	rural	
simple	pure	
percentage	proportion	majority	
cwt	freestyle	speculated	
progressing	lagging	
reveal	hide	
praised	hailed	welcomed	
summer	winter	spring	
substantial	significant	outstanding	
makes	gives	takes	
note	figure	bill	mark	
further	soon	
depart	fiancee	
killed	destroyed	
registered	listed	
boy	soldier	girl	woman	man	
represented	formed	
injuries	injury	
teachers	students	members	
discrimination	tolerance	
runs	moves	
insight	delight	
hits	releases	
primary	current	
tissue	muscle	muscular	bone	gene	
danger	threat	
sharp	slight	loose	striking	stiff	
painted	displayed	
democratic	conservative	liberal	
finish	match	spell	
socialist	communist	
male	family	child	
reduce	improve	ensure	prevent	
magazines	interviews	videos	newspapers	
cutting	lifting	
fixed	specified	
searching	dealing	gathering	
tied	drawn	
lower	higher	greater	low	high	
mass	sea	
quality	performance	success	
proved	looked	remained	seemed	
space	network	
dead	hidden	missing	
infection	illness	inflammation	
resigned	withdrew	
started	began	
range	scale	
troop	flying	landing	
cited	concluded	confirmed	indicated	suggested	
stand	look	
read	write	speak	
campus	university	school	college	
daily	weekly	monthly	
sleep	capture	escape	
relationship	role	
mind	favour	
umpires	kuna	
long-term	healthy	
men	women	girls	boys	
hairy	crude	tomato	garlic	
pressed	helicopters	
replacing	removing	requiring	creating	
preparation	safety	relief	
lumber	copper	grain	
mines	banks	wells	
region	population	state	
unlikely	unclear	supposed	
slowly	quickly	rapidly	instantly	
cold	extreme	
forced	threatened	
factors	methods	sources	levels	
replace	remove	protect	
conditions	circumstances	
continue	begin	
night	morning	evening	day	
sports	sport	racing	cricket	football	
reflecting	bpd	
violation	disagreement	
contained	made	
theft	fraud	
thrown	beaten	
politics	democracy	
wish	promise	hope	
financing	savings	debt	
reading	speaking	publishing	writing	
level	point	
done	given	taken	
conclusion	moment	
diplomatic	parliamentary	presidential	electoral	
highly	very	relatively	extremely	
party	council	court	
implementation	provision	
birds	humans	
contest	challenge	
police	criminal	secret	
passengers	visitors	flights	buses	
extremist	secession	
guards	officials	officers	
drive	track	
driving	riding	
original	entire	main	same	
united	republic	
villagers	oil-for-food	
children	others	friends	people	
passed	ruled	
newspapers	videos	magazines	
debt	budget	savings	loan	financing	
calls	comments	questions	
so-called	fundamental	
think	want	know	
brought	sought	turned	
shots	rounds	pairs	
landing	flying	troop	
trends	populist	
fighter	squad	
peaceful	fierce	
socialists	investigated	
time	chance	condition	
sending	forcing	
ice	hot	big	
difficult	better	
sprint	rally	feeder	
compete	choose	earn	
bars	cars	vehicles	
seats	bills	
bank	house	
recorded	published	written	
firm	company	
suicide	terror	
table	picture	
squad	fighter	
rural	historic	coastal	
policies	laws	interests	
heroin	mutilated	
blow	drop	
favour	mind	
worth	looking	
between	from	
indicated	reflected	concluded	cited	suggested	
democracy	politics	
lagged	two-thirds	
culture	history	language	
dealer	maker	racket	
majority	proportion	exception	percentage	
omitted	cargoes	
establishment	bureau	ministry	
employee	buyer	customer	
island	village	town	islands	
broke	fell	drove	
moved	headed	joined	
continues	starts	begins	
has	have	had	
book	magazine	story	journal	publication	
clean	cool	
positive	negative	consistent	
declared	granted	
throughout	during	
difficulty	difficulties	trouble	
streets	roads	boats	
cost	benefits	costs	
exact	underlying	usual	precise	
tiny	solid	thin	
minister	secretary	president	mayor	governor	
smoke	paint	trim	
upstairs	contests	
should	must	could	might	can	shall	would	will	
regulation	reduction	
window	desk	room	
result	cause	
trail	tunnel	passage	route	
guidance	responsibility	
two	four	five	three	remaining	
roll	tie	
feed	catch	fly	
suffering	feeling	
manufacturer	operator	package	holder	
stage	phase	
coaching	timetable	
needed	required	meant	
beating	throwing	
reverse	changing	
became	was	were	
course	location	
questions	comments	calls	
resort	festival	calendar	
ordinary	independent	existing	
environmental	scientific	conservation	
reasonable	valid	clear	
removed	replaced	shut	
transferred	headed	
sic	smuggling	hanged	
bond	deposit	
reconciliation	relations	
customer	buyer	employee	
looks	faces	
focused	developed	
imported	blacks	
yards	quarters	
media	television	radio	news	
pay	demand	purchase	
closing	opening	starting	
chaos	conflict	dispute	conflicts	
proposed	planned	
dozen	strikeouts	
competition	race	
necessary	likely	possible	
results	changes	
happen	fail	expect	
taxi	ticket	bus	
suggested	reported	concluded	confirmed	cited	indicated	
thought	believed	considered	
urge	treat	highlight	
interested	willing	concerned	
supported	shared	maintained	
faced	gained	suffered	
located	operated	built	
seasons	stages	
patent	grant	post	
patrols	speculation	
introduced	included	produced	
sites	facilities	camps	
former	young	
elaborate	remarkable	entertaining	excellent	
pact	regime	
distribute	deliver	
big	hot	ice	
social	human	religious	
plane	wall	tower	yard	
drug	health	drugs	medical	
complete	direct	
independence	self-rule	sovereignty	reform	
forest	river	mountain	tree	
stories	figures	names	books	
outspoken	plantation	
overthrow	hurts	
forehand	jumped	
crossing	passage	route	
different	certain	multiple	
treatment	exposure	diet	disease	care	
made	carried	contained	
command	surrender	
developing	expanding	continuing	
prize	trophy	medal	
southeastern	tag	
days	hours	months	years	weeks	times	
locally	mainly	predominantly	mostly	
surrounded	filled	
minutes	seconds	hours	months	weeks	
voiced	desperate	
own	latest	
escape	capture	sleep	
injured	wounded	
extend	operate	
current	primary	
goals	decisions	
churches	schools	
gene	bone	tissue	
pick	toss	
experts	scientists	researchers	
candidates	voters	proposals	votes	
bpd	reflecting	
down	back	forward	off	
blacks	imported	
drought	harvest	crop	
structure	formation	
total	minimum	maximum	
quite	well	fairly	slightly	
single	double	standard	
intervention	involvement	colleagues	
trader	lows	
political	legal	
the	its	
bar	seat	
shows	plays	
strongly	closely	widely	clearly	
filed	issued	
one	this	
cattle	cotton	tobacco	food	
last	best	first	
radio	television	media	news	
hurt	upset	
equivalent	standard	
celebration	ceremony	festival	calendar	
directly	independently	
beach	street	
onto	into	
changes	results	
strikes	forces	kills	
play	date	show	
upper	middle	
pool	stadium	
particularly	especially	
miles	metres	
their	its	
measure	yield	estimate	
spend	enter	
improved	increased	refined	reduced	
vehicles	drivers	cars	bars	
wide	medium	
combat	defence	
highlight	urge	
pass	walk	climb	
right	face	
restore	establish	strengthen	protect	
child	family	male	
refuse	hide	
news	television	media	radio	
sitting	hanging	standing	
creating	providing	requiring	replacing	
parliament	congress	
national	international	official	
tense	sad	happy	
hurry	wait	fix	
believes	wants	knows	feels	tells	says	
premier	founding	
explanation	doubt	
sufficiently	second-longest	
medal	trophy	prize	
